1 1 1 1 1 1 1 1 1 1 1 1 1 1 1 1 1 1 1 1 1 1 1 1 1 1 1 1 1 1 1 1 1 1 1 1 1 1 1 1 1 1 1 1 1 1 1 1 26 26 26 26 26 26 26 26 26 26 26 26 26 26 26 26 
1 6 7 8 8 8 9 1 0 0 0 0 0 0 0 1 1 0 0 0 0 4 4 4 4 4 4 4 0 0 0 1 1 0 0 0 0 0 0 0 0 0 0 0 0 0 0 1 26 26 26 26 26 26 26 26 26 26 26 26 26 26 26 26
1 10 11 12 12 12 13 1 0 0 0 0 0 0 0 1 1 0 0 2 0 4 28 28 28 28 28 4 0 2 0 1 1 0 0 0 0 0 0 0 0 0 0 2 0 0 0 1 26 26 4 4 4 4 4 4 4 4 4 4 4 4 26 26
1 14 15 16 17 18 19 1 0 0 0 0 0 0 0 1 1 0 0 0 0 4 28 28 28 28 28 4 0 0 0 1 1 0 0 0 0 0 0 0 0 0 0 0 0 0 0 1 26 26 4 27 5 5 5 5 5 5 5 5 27 4 26 26
1 20 21 22 23 24 25 0 0 0 0 0 0 0 1 1 1 1 0 0 0 4 4 4 28 4 4 4 0 0 1 1 1 1 0 0 0 0 0 0 0 0 0 0 0 0 0 1 26 26 4 5 5 5 5 5 5 5 5 5 5 4 26 26
1 0 0 0 0 0 0 0 2 0 0 0 0 0 0 0 0 0 0 0 0 0 0 0 0 0 0 0 0 0 0 0 0 0 0 0 0 0 0 0 0 0 0 0 0 0 0 1 26 26 4 5 5 5 5 5 5 5 5 5 5 4 26 26
1 0 0 0 0 0 0 0 0 0 0 0 0 0 0 0 0 0 0 0 0 0 0 0 0 0 0 0 0 0 0 0 0 0 0 0 0 0 0 0 0 0 0 0 0 0 0 1 26 26 4 31 5 5 5 5 5 5 5 5 31 4 26 26
1 0 0 0 0 0 0 0 0 0 0 0 0 0 1 1 1 1 0 0 0 0 0 0 0 0 0 0 0 0 1 1 1 1 0 0 0 0 0 0 0 0 0 0 0 0 0 1 26 26 4 5 5 5 5 5 5 5 5 5 5 4 26 26
1 0 0 0 0 0 0 0 0 0 0 0 0 0 0 1 1 0 0 0 0 0 0 0 0 0 0 0 0 0 0 1 1 0 0 0 0 0 0 0 0 0 0 0 0 0 0 1 26 26 4 5 5 5 5 5 5 5 5 5 5 4 26 26
1 0 0 0 0 0 0 0 0 0 0 0 0 0 0 1 1 0 0 0 0 0 0 0 0 0 0 0 0 0 0 1 1 0 0 0 0 0 0 0 0 0 0 0 0 0 0 1 26 26 4 5 5 5 5 5 5 5 5 5 5 4 26 26
1 0 0 0 0 0 0 0 0 0 0 0 0 0 0 1 1 0 0 0 0 0 0 0 0 0 0 0 0 0 0 1 1 0 0 0 0 0 1 0 0 1 0 0 0 0 0 1 26 26 4 4 4 4 4 5 5 4 4 4 4 4 26 26
1 1 1 1 1 1 1 1 1 1 1 1 1 1 1 1 1 1 1 1 1 1 1 1 1 1 1 1 1 1 1 1 1 1 1 1 1 1 1 0 0 1 1 1 1 1 1 1 26 26 26 26 26 26 4 5 5 4 26 26 26 26 26 26
1 1 1 1 1 1 1 1 1 1 1 1 1 1 1 1 1 1 1 1 1 1 1 1 1 1 1 1 1 1 1 1 1 1 1 1 1 1 1 0 0 1 1 1 1 1 1 1 4 4 4 4 4 4 4 4 4 4 4 4 4 4 4 4
1 0 0 0 0 0 0 0 0 0 0 0 0 0 0 1 1 0 0 0 0 0 0 0 0 0 0 0 0 0 0 1 1 0 0 0 0 0 1 0 0 1 0 0 0 0 0 1 4 28 28 28 28 28 28 28 28 28 28 28 28 28 28 4
1 0 0 0 0 0 0 0 0 0 0 0 0 0 0 1 1 0 0 0 0 0 0 0 0 0 0 0 0 0 0 1 1 0 0 0 0 0 0 0 0 0 0 0 0 0 0 1 4 28 28 28 28 28 28 28 28 28 28 28 28 28 28 4
1 0 0 0 0 0 0 0 0 0 0 0 0 0 0 1 1 0 0 0 0 3 3 3 3 3 3 3 3 3 0 1 1 0 0 2 0 0 0 0 0 0 0 4 4 4 4 1 4 28 28 28 28 28 28 28 28 28 28 28 28 28 28 4
1 0 0 0 0 0 0 0 0 0 0 0 0 0 1 1 1 1 0 0 0 3 29 29 29 29 29 29 29 3 0 1 1 0 0 0 0 0 0 0 0 0 0 4 28 28 4 1 4 28 28 28 28 28 28 28 28 28 28 28 28 28 28 4
1 0 0 0 0 0 0 0 0 0 0 0 0 0 0 0 0 0 0 0 0 3 29 30 30 30 30 30 29 3 0 1 1 0 0 0 0 0 0 0 0 0 0 4 28 28 4 1 4 28 28 28 28 28 28 28 28 28 28 28 28 28 28 4
1 0 0 0 0 0 0 0 0 0 0 0 0 0 0 0 0 0 0 0 0 3 29 30 30 30 30 30 29 3 0 1 1 0 0 0 0 0 0 0 0 0 0 28 28 28 4 1 4 28 28 28 28 28 28 28 28 28 28 28 28 28 28 4
1 0 0 0 0 0 0 0 0 0 0 0 0 0 1 1 1 1 0 0 0 3 29 29 29 30 29 29 29 3 0 1 1 0 0 0 0 0 0 0 0 0 0 4 28 28 4 1 4 28 28 28 28 28 28 28 28 28 28 28 28 28 28 4
1 0 0 0 0 0 0 0 0 0 0 0 0 0 0 1 1 0 0 0 0 3 3 3 29 30 29 3 3 3 0 1 1 0 0 0 0 0 0 0 0 0 0 4 28 28 4 1 4 28 28 28 28 28 28 28 28 28 28 28 28 28 28 4
1 0 0 0 0 0 0 0 0 0 0 0 0 0 0 1 1 0 0 0 0 0 0 0 0 0 0 0 0 0 0 1 1 0 0 0 0 0 0 0 0 0 0 4 4 4 4 1 4 28 28 28 28 28 28 28 28 28 28 28 28 28 28 4
1 0 0 0 0 0 1 0 0 1 0 0 0 0 0 1 1 0 0 0 0 0 0 0 0 0 0 0 0 0 0 1 1 0 0 0 0 0 1 0 0 1 0 0 0 0 0 1 4 28 28 28 28 28 28 28 28 28 28 28 28 28 28 4
1 1 1 1 1 1 1 0 0 1 1 1 1 1 1 1 1 1 1 1 1 1 1 1 1 1 1 1 1 1 1 1 1 1 1 1 1 1 1 0 0 1 1 1 1 1 1 1 26 26 26 26 26 26 26 26 26 26 26 26 26 26 26 26
1 1 1 1 1 1 1 0 0 1 1 1 1 1 1 1 1 1 1 1 1 1 1 1 1 1 1 1 1 1 1 1 1 1 1 1 1 1 1 0 0 1 1 1 1 1 1 1 3 3 3 3 3 3 3 3 3 3 3 3 3 3 3 3
1 0 0 0 0 0 1 0 0 1 0 0 0 0 0 1 1 0 0 0 0 0 0 0 0 0 0 0 0 0 0 1 1 0 0 0 0 0 1 0 0 1 0 0 0 0 0 1 3 29 29 29 29 29 29 29 29 29 29 29 29 29 29 3
1 0 0 0 0 0 0 0 0 0 0 0 0 0 0 1 1 0 0 0 0 0 0 0 0 0 0 0 0 0 0 1 1 0 0 0 0 0 0 0 0 0 0 0 0 0 0 1 3 29 30 30 30 30 30 30 30 30 30 30 30 30 29 3
1 0 0 0 0 0 0 0 0 0 0 0 0 2 0 1 1 0 0 0 0 0 0 0 0 0 0 0 0 0 0 1 1 0 0 0 0 0 0 0 0 0 0 0 0 0 0 1 3 29 30 30 30 30 30 30 30 30 30 30 30 30 29 3
1 0 0 0 0 0 0 0 0 0 0 0 0 0 1 1 1 1 0 0 0 0 0 0 0 0 0 0 0 0 1 1 1 1 0 0 0 0 0 0 0 0 0 0 0 0 0 1 3 29 30 30 30 30 30 30 30 30 30 30 30 30 29 3
1 0 0 0 0 0 0 0 0 0 0 0 0 0 0 0 0 0 0 0 0 0 0 0 0 0 0 0 0 0 0 0 0 0 0 0 0 0 0 0 0 0 0 2 0 0 0 1 3 29 30 30 30 30 30 30 30 30 30 30 30 30 29 3
1 0 0 0 0 0 0 0 0 0 0 0 0 0 0 0 0 0 0 0 0 0 0 0 0 0 0 0 0 0 0 0 0 0 0 0 0 0 0 0 0 0 0 0 0 0 0 1 3 29 30 30 30 30 30 30 30 30 30 30 30 30 29 3
1 0 2 0 0 0 0 0 0 0 0 0 0 0 1 1 1 1 0 0 0 4 4 4 28 4 4 4 0 0 1 1 1 1 0 0 0 0 0 0 0 0 0 0 0 0 0 1 3 29 30 30 30 30 30 30 30 30 30 30 30 30 29 3
1 0 0 0 0 0 0 0 0 0 0 0 0 0 0 1 1 0 0 0 0 4 28 28 28 28 28 4 0 0 0 1 1 0 0 0 0 0 0 0 0 0 0 0 0 0 0 1 3 29 30 30 30 30 30 30 30 30 30 30 30 30 29 3
1 0 1 0 0 0 0 0 0 0 0 0 0 0 0 1 1 0 0 2 0 4 28 28 28 28 28 4 0 2 0 1 1 0 0 0 0 0 0 0 0 0 0 0 0 0 0 1 3 29 30 30 30 30 30 30 30 30 30 30 30 30 29 3
1 0 0 0 0 0 0 0 0 0 0 0 0 0 0 1 1 0 0 0 0 4 4 4 4 4 4 4 0 0 0 1 1 0 0 0 0 0 0 0 0 0 0 0 0 0 0 1 3 29 29 29 29 29 29 29 29 29 29 29 29 29 29 3
1 1 1 1 1 1 1 1 1 1 1 1 1 1 1 1 1 1 1 1 1 1 1 1 1 1 1 1 1 1 1 1 1 1 1 1 1 1 1 1 1 1 1 1 1 1 1 1 3 3 3 3 3 3 3 3 3 3 3 3 3 3 3 3